15 15
###############
#*...*..*#..*.#
#.O..O...#....#
#...##...#....#
#...##...#....#
#.....O..#....#
#.O......#....#
#.......@#....#
#*...*..*#....#
#....O...#....#
#...##...#....#
#.....O..#....#
#.O...........#
#.............#
###############